Category,Subcategory,Description,Notes,Vendor,Start Date,Duration,End Date,Amount,Balance
Revenue,HUD,HUD drawdown #11,submitted ,Hud Drawdown,2/20/25,1,2/21/25,163741.65,368776.84
Equipment,Zepole,Equipment Sales Order,Need to confirm adjusted payment plan with Zepole,Zepole,2/24/25,1,2/25/25,-102145.17,266631.67
Salary,Payroll (admin),Payroll (admin),estimate,Payroll (admin),2/28/25,1,3/1/25,-6127.53,260504.14
Debt Service,Embassy,Interest,interest,Embassy,3/1/25,1,3/2/25,-2057.3,258446.84
Other,Marketing,Consulting (Website),recurring,Fresh Ink,3/1/25,1,3/2/25,-300,258146.84
Occupancy,Rent,Rent,recurring,Market Flats,3/1/25,1,3/2/25,-14829,243317.84
Revenue,PayPal,Paypal Donations,member equity,Paypal,3/1/25,1,3/2/25,1000,244317.84
Revenue,HUD,HUD drawdown # 10,submitted,Hud Drawdown,3/3/25,1,3/4/25,35830.92,280148.76
Equipment,Zepole,Equipment Sales Order,Need to confirm adjusted payment plan with Zepole,Zepole,3/3/25,1,3/4/25,-150000,130148.76
Occupancy,Insurance,Insurance,recurring,Cincinnati Insurance,3/4/25,1,3/5/25,-1483,128665.76
Supplies & Materials,Interior Decor,Décor Package (Vendor TBD),Downpayment - terms and date subject to change,Decor,3/4/25,1,3/5/25,-35000,93665.76
Debt Service,LEAF,Interest,interest,LEAF,3/5/25,1,3/6/25,-2333.33,91332.43
Salary,Payroll (admin),Payroll (admin),estimate,Payroll (admin),3/7/25,1,3/8/25,-6580.68,84751.75
Occupancy,Utilities,Electric (Estimated),recurring,PPL,3/9/25,1,3/10/25,-1100,83651.75
Revenue,HUD,HUD drawdown #12,"Includes Equipment, Occupancy and Salary from February",Hud Drawdown,3/10/25,1,3/11/25,292293.38,375945.13
Project Management,SBS,Estimated Consulting Hours Refill,estimate,SBS,3/11/25,1,3/12/25,-5500,370445.13
Salary,Payroll (admin),Payroll (admin),estimate,Payroll (admin),3/14/25,1,3/15/25,-5040.68,365404.45
Construction,Low Voltage,Low Voltage Install,due on completion,Micro Innovation,3/15/25,1,3/16/25,-9826.16,355578.29
Debt Service,Penn,Interest,recurring,Penn,3/15/25,1,3/16/25,-5250,350328.29
Equipment,Aperion,Electronic Tag System,This bill was generated but never delivered,Aperion,3/21/25,1,3/22/25,-15383.3,334944.99
Salary,Payroll (admin),Payroll (admin),estimate,Payroll (admin),3/21/25,1,3/22/25,-5040.68,329904.31
Salary,Payroll (admin),Payroll (admin),estimate,Payroll (admin),3/28/25,1,3/29/25,-5040.68,324863.63
Equipment,Aperion,Electronic Tag System,terms not defined -estimate,Aperion,3/30/25,1,3/31/25,-32991.7,291871.93
Debt Service,Embassy,Interest,interest,Embassy,4/1/25,1,4/2/25,-2057.3,289814.63
Other,Marketing,Consulting (Website),recurring,Fresh Ink,4/1/25,1,4/2/25,-300,289514.63
Occupancy,Rent,Rent,recurring,Market Flats,4/1/25,1,4/2/25,-14829,274685.63
Revenue,PayPal,Paypal Donations,member equity,Paypal,4/1/25,1,4/2/25,1000,275685.63
Occupancy,Insurance,Insurance,recurring,Cincinnati Insurance,4/4/25,1,4/5/25,-1483,274202.63
Salary,Payroll (admin),Payroll (admin),estimate,Payroll (admin),4/4/25,1,4/5/25,-5040.68,269161.95
Debt Service,LEAF,Interest,principal + interest,LEAF,4/5/25,1,4/6/25,-6037.07,263124.88
Occupancy,Utilities,Electric (Estimated),recurring,PPL,4/9/25,1,4/10/25,-1100,262024.88
Salary,Payroll (admin),Payroll (admin),estimate,Payroll (admin),4/11/25,1,4/12/25,-5040.68,256984.20
Project Management,SBS,Estimated Consulting Hours Refill,estimate,SBS,4/11/25,1,4/12/25,-5500,251484.20
Equipment,Zepole,Equipment Sales Order,current payment plan - need to renegotiate,Zepole,4/14/25,1,4/15/25,-315181.45,-63697.25
Revenue,HUD,HUD drawdown #13,"Includes Equipment, Occupancy and Salary from March",Hud Drawdown,4/15/25,1,4/16/25,210597.34,146900.09
Debt Service,Penn,Interest,recurring,Penn,4/15/25,1,4/16/25,-5250,141650.09
Salary,Payroll (admin),Payroll (admin),estimate,Payroll (admin),4/18/25,1,4/19/25,-5040.68,136609.41
Salary,Payroll (admin),Payroll (admin),estimate,Payroll (admin),4/25/25,1,4/26/25,-5040.68,131568.73
Debt Service,Embassy,Interest,interest,Embassy,5/1/25,1,5/2/25,-2057.3,129511.43
Other,Marketing,Consulting (Website),recurring,Fresh Ink,5/1/25,1,5/2/25,-300,129211.43
Occupancy,Rent,Rent,recurring,Market Flats,5/1/25,1,5/2/25,-14829,114382.43
Revenue,PayPal,Paypal Donations,member equity,Paypal,5/1/25,1,5/2/25,1000,115382.43
Equipment,Coffee Equipment,Coffee Bar Equipment,estimate,Zepole,5/1/25,1,5/2/25,-18000,97382.43
Supplies & Materials,Small Wares,Kitchen Small Wares,estimate,Zepole,5/1/25,1,5/2/25,-18000,79382.43
Salary,Payroll (admin),Payroll (admin),estimate,Payroll (admin),5/2/25,1,5/3/25,-5040.68,74341.75
Revenue,HUD,HUD drawdown #14,Includes Occupancy From April + May,Hud Drawdown,5/3/25,1,5/4/25,89829,164170.75
Occupancy,Insurance,Insurance,recurring,Cincinnati Insurance,5/5/25,1,5/6/25,-1483,162687.75
Debt Service,LEAF,Interest,principal + interest,LEAF,5/5/25,1,5/6/25,-6037.07,156650.68
Salary,Payroll (admin),Payroll (admin),estimate,Payroll (admin),5/9/25,1,5/10/25,-5040.68,151610.00
Occupancy,Utilities,Electric (Estimated),recurring,PPL,5/9/25,1,5/10/25,-1100,150510.00
Project Management,SBS,Estimated Consulting Hours Refill,estimate,SBS,5/11/25,1,5/12/25,-5500,145010.00
Debt Service,Penn,Interest,recurring,Penn,5/15/25,1,5/16/25,-5250,139760.00
Salary,Payroll (admin),Payroll (admin),estimate,Payroll (admin),5/16/25,1,5/17/25,-5040.68,134719.32
Salary,Payroll (store),Payroll (store),estimate,Payroll (store),5/16/25,1,5/17/25,-7000,127719.32
Salary,Payroll (admin),Payroll (admin),estimate,Payroll (admin),5/23/25,1,5/24/25,-5040.68,122678.64
Salary,Payroll (store),Payroll (store),estimate,Payroll (store),5/23/25,1,5/24/25,-7000,115678.64
Equipment,ECRS,Registers + other POS equipment,estimated install date,ECRS,5/30/25,1,5/31/25,-83318.11,32360.53
Salary,Payroll (admin),Payroll (admin),estimate,Payroll (admin),5/30/25,1,5/31/25,-5040.68,27319.85
Salary,Payroll (store),Payroll (store),estimate,Payroll (store),5/30/25,1,5/31/25,-7000,20319.85
Equipment,Zepole,Equipment Sales Order,due on completion,Zepole,5/31/25,1,6/1/25,-59799.05,-39479.20
Supplies & Materials,Interior Decor,Décor Package (Vendor TBD),Due on Completion - terms and date subject to change,Decor,6/1/25,1,6/2/25,-22000,-61479.20
Debt Service,Embassy,Interest,interest,Embassy,6/1/25,1,6/2/25,-2057.3,-63536.50
Other,Marketing,Consulting (Website),recurring,Fresh Ink,6/1/25,1,6/2/25,-300,-63836.50
Occupancy,Rent,Rent,recurring,Market Flats,6/1/25,1,6/2/25,-14829,-78665.50
Revenue,PayPal,Paypal Donations,member equity,Paypal,6/1/25,1,6/2/25,1000,-77665.50
Debt Service,Embassy,Loan Payoff,interest,Embassy,6/4/25,1,6/5/25,-400000,-477665.50
Debt Service,LEAF,Interest,principal + interest,LEAF,6/5/25,1,6/6/25,-6037.07,-483702.57
Occupancy,Insurance,Insurance,recurring,Cincinnati Insurance,6/6/25,1,6/7/25,-1483,-485185.57
Salary,Payroll (admin),Payroll (admin),estimate,Payroll (admin),6/6/25,1,6/7/25,-5040.68,-490226.25
Salary,Payroll (store),Payroll (store),estimate,Payroll (store),6/6/25,1,6/7/25,-7000,-497226.25
Occupancy,Utilities,Electric (Estimated),recurring,PPL,6/9/25,1,6/10/25,-1100,-498326.25
Project Management,SBS,Estimated Consulting Hours Refill,estimate,SBS,6/11/25,1,6/12/25,-5500,-503826.25
Salary,Payroll (admin),Payroll (admin),estimate,Payroll (admin),6/13/25,1,6/14/25,-5040.68,-508866.93
Salary,Payroll (store),Payroll (store),estimate,Payroll (store),6/13/25,1,6/14/25,-17088.15,-525955.08
Other,Opening Inventory,Opening Inventory,estimate - based on Pro Forma,KeHe,6/15/25,1,6/16/25,-321336.25,-847291.33
Debt Service,Penn,Interest,recurring,Penn,6/15/25,1,6/16/25,-5250,-852541.33
Debt Service,Penn,Loan Payoff,recurring,Penn,6/15/25,1,6/16/25,-700000,-1552541.33
Revenue,HUD,HUD drawdown #15,Includes Occupancy + Other (Inventory),Hud Drawdown,6/18/25,1,6/19/25,240185.89,-1312355.44
Salary,Payroll (admin),Payroll (admin),estimate,Payroll (admin),6/20/25,1,6/21/25,-5040.68,-1317396.12
Salary,Payroll (store),Payroll (store),estimate,Payroll (store),6/20/25,1,6/21/25,-17088.15,-1334484.27
Salary,Payroll (admin),Payroll (admin),estimate,Payroll (admin),6/27/25,1,6/28/25,-5040.68,-1339524.95
Salary,Payroll (store),Payroll (store),estimate,Payroll (store),6/27/25,1,6/28/25,-17088.15,-1356613.10
Revenue,Store Revenue,Projected Store Revenue,Based on Pro Forma,BCM,7/1/25,1,7/2/25,17173.03,-1339440.07
Construction,Construction,unbilled (including retainage),due on completion,Boyle,7/1/25,1,7/2/25,-155267.14,-1494707.21
Occupancy,Rent,Rent,recurring,Market Flats,7/1/25,1,7/2/25,-14829,-1509536.21
Revenue,PayPal,Paypal Donations,member equity,Paypal,7/1/25,1,7/2/25,1000,-1508536.21
Revenue,Store Revenue,Projected Store Revenue,Based on Pro Forma,Store Revenue,7/2/25,1,7/3/25,17173.03,-1491363.18
Revenue,Store Revenue,Projected Store Revenue,Based on Pro Forma,Store Revenue,7/3/25,1,7/4/25,17173.03,-1474190.15
Revenue,Store Revenue,Projected Store Revenue,Based on Pro Forma,Store Revenue,7/4/25,1,7/5/25,17173.03,-1457017.12
Occupancy,Insurance,Insurance,recurring,Cincinnati Insurance,7/4/25,1,7/5/25,-1483,-1458500.12
Revenue,Store Revenue,Projected Store Revenue,Based on Pro Forma,Store Revenue,7/5/25,1,7/6/25,17173.03,-1441327.09
Debt Service,LEAF,Interest,principal + interest,LEAF,7/5/25,1,7/6/25,-6037.07,-1447364.16
Revenue,Store Revenue,Projected Store Revenue,Based on Pro Forma,Store Revenue,7/6/25,1,7/7/25,17173.03,-1430191.13
Revenue,Store Revenue,Projected Store Revenue,Based on Pro Forma,Store Revenue,7/7/25,1,7/8/25,17173.03,-1413018.10
Revenue,Store Revenue,Projected Store Revenue,Based on Pro Forma,Store Revenue,7/8/25,1,7/9/25,17173.03,-1395845.07
Revenue,Store Revenue,Projected Store Revenue,Based on Pro Forma,Store Revenue,7/9/25,1,7/10/25,17173.03,-1378672.04
Occupancy,Utilities,Electric (Estimated),recurring,PPL,7/9/25,1,7/10/25,-5000,-1383672.04
Revenue,Store Revenue,Projected Store Revenue,Based on Pro Forma,Store Revenue,7/10/25,1,7/11/25,17173.03,-1366499.01
Revenue,Store Revenue,Projected Store Revenue,Based on Pro Forma,Store Revenue,7/11/25,1,7/12/25,17173.03,-1349325.98
Revenue,Store Revenue,Projected Store Revenue,Based on Pro Forma,Store Revenue,7/12/25,1,7/13/25,17173.03,-1332152.95
Revenue,Store Revenue,Projected Store Revenue,Based on Pro Forma,Store Revenue,7/13/25,1,7/14/25,17173.03,-1314979.92
Revenue,Store Revenue,Projected Store Revenue,Based on Pro Forma,Store Revenue,7/14/25,1,7/15/25,17173.03,-1297806.89
Revenue,Store Revenue,Projected Store Revenue,Based on Pro Forma,Store Revenue,7/15/25,1,7/16/25,17173.03,-1280633.86
Revenue,Store Revenue,Projected Store Revenue,Based on Pro Forma,Store Revenue,7/16/25,1,7/17/25,17173.03,-1263460.83
Revenue,Store Revenue,Projected Store Revenue,Based on Pro Forma,Store Revenue,7/17/25,1,7/18/25,17173.03,-1246287.80
Revenue,Store Revenue,Projected Store Revenue,Based on Pro Forma,Store Revenue,7/18/25,1,7/19/25,17173.03,-1229114.77
Revenue,Store Revenue,Projected Store Revenue,Based on Pro Forma,Store Revenue,7/19/25,1,7/20/25,17173.03,-1211941.74
Revenue,Store Revenue,Projected Store Revenue,Based on Pro Forma,Store Revenue,7/20/25,1,7/21/25,17173.03,-1194768.71
Revenue,Store Revenue,Projected Store Revenue,Based on Pro Forma,Store Revenue,7/21/25,1,7/22/25,17173.03,-1177595.68
Revenue,Store Revenue,Projected Store Revenue,Based on Pro Forma,Store Revenue,7/22/25,1,7/23/25,17173.03,-1160422.65
Revenue,Store Revenue,Projected Store Revenue,Based on Pro Forma,Store Revenue,7/23/25,1,7/24/25,17173.03,-1143249.62
Revenue,Store Revenue,Projected Store Revenue,Based on Pro Forma,Store Revenue,7/24/25,1,7/25/25,17173.03,-1126076.59
Revenue,Store Revenue,Projected Store Revenue,Based on Pro Forma,Store Revenue,7/25/25,1,7/26/25,17173.03,-1108903.56
Revenue,Store Revenue,Projected Store Revenue,Based on Pro Forma,Store Revenue,7/26/25,1,7/27/25,17173.03,-1091730.53
Revenue,Store Revenue,Projected Store Revenue,Based on Pro Forma,Store Revenue,7/27/25,1,7/28/25,17173.03,-1074557.50
Revenue,Store Revenue,Projected Store Revenue,Based on Pro Forma,Store Revenue,7/28/25,1,7/29/25,17173.03,-1057384.47
Revenue,Store Revenue,Projected Store Revenue,Based on Pro Forma,Store Revenue,7/29/25,1,7/30/25,17173.03,-1040211.44
Revenue,Store Revenue,Projected Store Revenue,Based on Pro Forma,Store Revenue,7/30/25,1,7/31/25,17173.03,-1023038.41
Revenue,Store Revenue,Projected Store Revenue,Based on Pro Forma,Store Revenue,7/31/25,1,8/1/25,17173.03,-1005865.38
